37 37 9
textures/wall_2.xpm
textures/wall_1.xpm
textures/wall_3.xpm
textures/wall_4.xpm
textures/wall_6.xpm
textures/wall_7.xpm
textures/wall_8.xpm
textures/wall_9.xpm
0
9 9 9 9 9 9 9 9 4 4 1 1 1 1 1 1 1 1 1 1 1 1 8 8 8 8 8 8 8 8 8 8 8 8 8 8 8
9 0 0 0 0 0 0 0 4 4 0 0 0 0 0 0 0 0 0 0 2 1 0 0 0 0 0 0 0 0 0 0 0 0 0 0 8
9 0 0 0 0 0 0 0 4 4 0 0 0 0 0 0 0 0 0 0 2 1 0 0 0 0 0 0 0 0 0 0 0 0 0 0 8
9 0 0 0 4 4 4 4 4 4 0 0 7 7 0 0 1 1 1 1 1 1 1 1 1 1 0 0 1 1 1 1 1 1 0 0 8
9 0 0 0 4 4 4 4 4 4 0 0 7 7 0 0 1 1 1 1 1 1 1 1 1 1 0 0 1 1 1 1 1 1 0 0 8
9 0 0 0 0 0 0 0 0 0 0 0 7 7 0 0 0 0 0 0 1 1 0 0 0 0 0 0 1 8 0 0 0 0 0 0 8
9 0 0 0 0 0 0 0 0 0 0 0 7 7 0 0 0 0 0 0 1 1 0 0 0 0 0 0 1 8 0 0 0 0 0 0 8
9 0 0 0 0 0 0 0 0 0 0 0 3 1 1 1 1 1 0 0 1 1 0 0 1 1 1 1 1 1 1 1 1 1 0 0 8
9 0 0 0 0 0 0 2 2 0 0 0 3 1 1 1 1 1 0 0 7 7 0 0 1 1 1 1 1 1 1 1 1 1 0 0 8
9 7 0 0 0 0 0 0 0 0 0 0 3 3 0 0 1 1 0 0 0 0 0 0 1 1 0 0 0 0 0 0 0 0 0 0 8
1 7 0 0 0 0 0 0 0 0 0 0 3 3 0 0 1 1 0 0 0 0 0 0 1 1 0 0 0 0 0 0 0 0 0 0 8
1 7 0 0 0 0 0 5 5 5 5 5 5 5 0 0 1 1 5 5 4 4 6 6 1 1 0 0 9 6 6 6 6 9 0 0 8
1 7 0 0 0 0 0 5 8 4 4 4 4 1 0 0 1 1 1 1 1 1 1 1 1 1 0 0 1 1 1 1 1 1 0 0 8
1 7 0 0 0 0 0 0 8 4 0 0 4 1 0 0 0 0 0 0 1 1 0 0 0 0 0 0 0 0 0 0 1 1 0 0 8
1 7 0 0 0 0 0 0 8 4 0 0 4 1 0 0 0 0 0 0 1 1 0 0 0 0 0 0 0 0 0 0 1 1 0 0 8
1 7 0 0 7 7 0 0 8 4 0 0 4 1 1 1 1 1 0 0 1 1 0 0 3 3 3 3 3 3 0 0 1 1 0 0 8
1 7 0 0 7 7 0 0 8 4 0 0 4 2 2 2 2 1 0 0 2 2 0 0 3 3 3 3 3 3 0 0 1 1 0 0 8
1 7 0 0 7 7 0 0 8 8 0 0 0 0 0 0 2 1 0 0 0 0 0 0 0 0 0 0 0 0 0 0 1 1 0 0 8
1 7 0 0 7 7 0 0 8 8 0 0 0 0 0 0 2 1 0 0 0 0 0 0 0 0 0 0 0 0 0 0 1 1 0 0 8
1 7 7 7 7 7 0 0 8 8 8 8 8 8 0 0 2 1 1 1 1 1 1 1 1 1 1 1 1 1 1 1 1 1 1 1 1
1 7 7 7 7 7 0 0 8 8 8 8 8 8 0 0 2 2 2 2 2 2 2 2 5 5 5 5 5 1 1 1 1 1 1 1 1
1 7 0 7 0 0 0 0 0 0 0 0 0 0 0 0 0 0 0 0 0 0 0 0 0 0 0 0 5 1 0 0 0 0 0 0 1
1 7 0 0 0 0 0 0 0 0 0 0 0 0 0 0 0 0 0 0 0 0 0 0 0 0 0 0 5 1 0 0 0 0 0 0 1
1 7 0 0 1 1 0 0 8 8 0 0 8 1 1 1 1 1 0 0 0 0 0 0 5 5 5 5 5 1 1 1 0 0 8 8 1
1 7 0 0 1 1 0 0 8 8 0 0 8 1 1 1 1 1 0 0 0 0 0 0 1 1 1 1 1 1 1 1 0 0 8 8 1
1 7 0 0 1 1 0 0 8 8 0 0 8 2 0 0 0 0 0 0 0 0 0 0 0 0 0 0 0 0 0 0 0 0 0 0 1
1 7 0 0 1 1 0 0 8 8 0 0 8 2 0 0 0 0 0 0 0 0 0 0 0 0 0 0 0 0 0 0 0 0 0 0 1
1 7 0 0 1 1 1 1 1 1 0 0 8 9 9 9 9 9 0 0 0 0 0 0 6 6 6 6 6 6 6 6 6 6 0 0 1
1 7 0 0 1 1 1 1 1 1 0 0 8 9 9 9 9 9 0 0 0 0 0 0 6 6 6 6 6 6 6 6 6 6 0 0 1
1 7 0 0 0 0 0 0 0 0 0 0 8 9 0 0 0 0 0 0 0 0 0 0 0 0 0 0 6 6 0 0 0 0 0 0 1
1 7 0 0 0 0 0 0 0 0 0 0 8 9 0 0 0 0 0 0 0 0 0 0 0 0 0 0 6 6 0 0 0 0 0 0 1
1 7 7 7 7 7 0 0 8 8 8 8 8 9 0 0 3 3 3 3 3 3 0 0 6 6 6 6 6 6 6 6 6 6 0 0 1
8 8 8 8 8 7 0 0 8 9 9 9 9 9 0 0 3 3 3 3 3 3 0 0 6 6 6 6 6 6 6 6 6 6 0 0 1
8 0 0 0 0 0 0 0 8 9 0 0 0 0 0 0 3 3 0 0 0 0 0 0 0 0 0 0 0 0 0 0 0 0 0 0 1
8 0 0 0 0 0 0 0 8 9 0 0 0 0 0 0 3 3 0 0 0 0 0 0 0 0 0 0 0 0 0 0 0 0 0 0 1
8 8 8 8 8 8 8 8 8 9 9 9 9 9 0 0 3 3 3 3 3 3 3 3 3 3 3 3 3 3 3 3 3 3 3 3 1
1 1 1 1 1 1 1 1 1 1 1 1 1 3 3 3 3 1 1 1 1 1 1 1 1 1 1 1 1 1 1 1 1 1 1 1 1
